11111111111111111111111111111111
11111111111111111111111111111111
11111111111111111111111111111111
11111111111111111111111111111111
111111111P0000000000001111111111
11111111101010101010101111111111
11111111100C0C0C0C0C001111111111
11111111101010101010101111111111
11111111100C0C0C0C0C001111111111
11111111101010101010101111111111
11111111100C0C0C0C0C001111111111
11111111101010101010111111111111
111111111000000000001E1111111111
11111111111111111111111111111111
11111111111111111111111111111111
11111111111111111111111111111111
11111111111111111111111111111111
11111111111111111111111111111111
